13 13
####.....####
####.#.#.####
##...#.#...##
##.###.###.##
...###.###...
.#####.#####.
.............
.#####.#####.
...###.###...
##.###.###.##
##...#.#...##
####.#.#.####
####.....####
